7,5,5,5,5,5,5,5,5,8
6,0,0,0,0,0,0,0,0,6
6,0,0,0,0,0,0,0,0,6
6,0,0,0,0,0,0,0,0,6
6,0,0,0,0,0,0,0,0,6
9,5,5,5,5,5,5,5,5,10